"filename", "language", "Python", "Java", "XML", "comment", "blank", "total"
"d:\pkr_study\08-力扣\codes\.idea\codes.iml", "XML", 0, 0, 11, 0, 0, 11
"d:\pkr_study\08-力扣\codes\.idea\deployment.xml", "XML", 0, 0, 21, 0, 0, 21
"d:\pkr_study\08-力扣\codes\.idea\inspectionProfiles\profiles_settings.xml", "XML", 0, 0, 6, 0, 0, 6
"d:\pkr_study\08-力扣\codes\.idea\misc.xml", "XML", 0, 0, 4, 0, 0, 4
"d:\pkr_study\08-力扣\codes\.idea\modules.xml", "XML", 0, 0, 8, 0, 0, 8
"d:\pkr_study\08-力扣\codes\Main.java", "Java", 0, 0, 0, 0, 1, 1
"d:\pkr_study\08-力扣\codes\a\a01-美好字符串.py", "Python", 42, 0, 0, 8, 8, 58
"d:\pkr_study\08-力扣\codes\a\a02-平方根.py", "Python", 23, 0, 0, 1, 5, 29
"d:\pkr_study\08-力扣\codes\a\a03-买票时间.py", "Python", 26, 0, 0, 0, 5, 31
"d:\pkr_study\08-力扣\codes\a\a04-数组中的字符串匹配.py", "Python", 22, 0, 0, 0, 5, 27
"d:\pkr_study\08-力扣\codes\a\a05-两数之和.py", "Python", 26, 0, 0, 0, 5, 31
"d:\pkr_study\08-力扣\codes\a\a06-字符出现次数.py", "Python", 20, 0, 0, 0, 4, 24
"d:\pkr_study\08-力扣\codes\a\a07-加一.py", "Python", 29, 0, 0, 0, 6, 35
"d:\pkr_study\08-力扣\codes\a\a08-对称二叉树.py", "Python", 27, 0, 0, 1, 6, 34
"d:\pkr_study\08-力扣\codes\a\a09-数据流中的第K大元素.py", "Python", 24, 0, 0, 3, 6, 33
"d:\pkr_study\08-力扣\codes\a\a10-只出现一次的数字.py", "Python", 22, 0, 0, 11, 6, 39
"d:\pkr_study\08-力扣\codes\a\a11-合并两个有序链表.py", "Python", 41, 0, 0, 55, 11, 107
"d:\pkr_study\08-力扣\codes\a\a12-有效的括号.py", "Python", 36, 0, 0, 2, 5, 43
"d:\pkr_study\08-力扣\codes\a\a13-同构字符串.py", "Python", 29, 0, 0, 25, 7, 61
"d:\pkr_study\08-力扣\codes\a\a14-二叉树的中序遍历.py", "Python", 31, 0, 0, 1, 7, 39
"d:\pkr_study\08-力扣\codes\a\a15-汉明距离.py", "Python", 34, 0, 0, 1, 5, 40
"d:\pkr_study\08-力扣\codes\a\a16-二叉树的直径.py", "Python", 31, 0, 0, 1, 7, 39
"d:\pkr_study\08-力扣\codes\a\a17-多数元素.py", "Python", 17, 0, 0, 0, 11, 28
"d:\pkr_study\08-力扣\codes\a\a18-爬楼梯.py", "Python", 16, 0, 0, 0, 2, 18
"d:\pkr_study\08-力扣\codes\a\a19-买卖股票的最佳时机含冷冻期.py", "Python", 17, 0, 0, 6, 4, 27
"d:\pkr_study\08-力扣\codes\a\a20-相交链表.py", "Python", 15, 0, 0, 4, 4, 23
"d:\pkr_study\08-力扣\codes\a\a21-回文链表.py", "Python", 33, 0, 0, 15, 10, 58
"d:\pkr_study\08-力扣\codes\a\a22-翻转二叉树.py", "Python", 21, 0, 0, 3, 8, 32
"d:\pkr_study\08-力扣\codes\a\a23-反转链表.py", "Python", 30, 0, 0, 19, 8, 57
"d:\pkr_study\08-力扣\codes\a\a24-环形链表.py", "Python", 21, 0, 0, 7, 14, 42
"d:\pkr_study\08-力扣\codes\a\a25-合并二叉树.py", "Python", 22, 0, 0, 7, 7, 36
"d:\pkr_study\08-力扣\codes\a\a26-找到所有数组中消失的数字.py", "Python", 18, 0, 0, 4, 3, 25
"d:\pkr_study\08-力扣\codes\a\a27-二叉树的最大深度.py", "Python", 17, 0, 0, 4, 5, 26
"d:\pkr_study\08-力扣\codes\a\a28-比特位计数.java", "Java", 0, 10, 0, 0, 1, 11
"d:\pkr_study\08-力扣\codes\a\a29-移动零.java", "Java", 0, 18, 0, 13, 1, 32
"d:\pkr_study\08-力扣\codes\a\a30-构成整天的下标对数目I.py", "Python", 19, 0, 0, 4, 3, 26
"d:\pkr_study\08-力扣\codes\a\a32-两数相除.java", "Java", 0, 29, 0, 0, 2, 31
"d:\pkr_study\08-力扣\codes\a\a33-二进制求和.java", "Java", 0, 37, 0, 3, 5, 45
"d:\pkr_study\08-力扣\codes\a\a34-比特位计数.java", "Java", 0, 15, 0, 2, 3, 20
"d:\pkr_study\08-力扣\codes\a\a35-两数之和II输入有序数组.java", "Java", 0, 23, 0, 4, 4, 31
"d:\pkr_study\08-力扣\codes\a\a36-合并两个有序数组.java", "Java", 0, 29, 0, 5, 3, 37
"d:\pkr_study\08-力扣\codes\a\a37-移除元素.java", "Java", 0, 19, 0, 6, 2, 27
"d:\pkr_study\08-力扣\codes\a\a38-删除有序数组中的重复项.java", "Java", 0, 23, 0, 6, 2, 31
"d:\pkr_study\08-力扣\codes\a\a39-多数元素.java", "Java", 0, 7, 0, 3, 4, 14
"d:\pkr_study\08-力扣\codes\a\a40-罗马数字转整数.py", "Python", 60, 0, 0, 0, 3, 63
"d:\pkr_study\08-力扣\codes\a\a41-最后一个单词的长度.py", "Python", 8, 0, 0, 9, 3, 20
"d:\pkr_study\08-力扣\codes\a\a42-最长公共前缀.py", "Python", 23, 0, 0, 3, 6, 32
"d:\pkr_study\08-力扣\codes\a\a43-找出字符串中第一个匹配项的下标.py", "Python", 29, 0, 0, 16, 9, 54
"d:\pkr_study\08-力扣\codes\a\a44-验证回文串.py", "Python", 26, 0, 0, 4, 5, 35
"d:\pkr_study\08-力扣\codes\a\a45-判断子序列.py", "Python", 22, 0, 0, 5, 5, 32
"d:\pkr_study\08-力扣\codes\a\a46-环形链表.py", "Python", 18, 0, 0, 4, 5, 27
"d:\pkr_study\08-力扣\codes\a\a47-合并两个有序链表.py", "Python", 27, 0, 0, 3, 7, 37
"d:\pkr_study\08-力扣\codes\a\a48-二叉树的最大深度.py", "Python", 9, 0, 0, 6, 1, 16
"d:\pkr_study\08-力扣\codes\a\a49-相同的树.py", "Python", 19, 0, 0, 1, 3, 23
"d:\pkr_study\08-力扣\codes\a\a50-翻转二叉树.py", "Python", 17, 0, 0, 1, 3, 21
"d:\pkr_study\08-力扣\codes\a\a51-对称二叉树.py", "Python", 20, 0, 0, 1, 4, 25
"d:\pkr_study\08-力扣\codes\a\a52-路径总和.py", "Python", 20, 0, 0, 1, 3, 24
"d:\pkr_study\08-力扣\codes\a\a53-完全二叉树的节点个数.py", "Python", 26, 0, 0, 11, 6, 43
"d:\pkr_study\08-力扣\codes\b\b01-前缀异或数组.py", "Python", 20, 0, 0, 1, 6, 27
"d:\pkr_study\08-力扣\codes\b\b02-查询带键的排列.py", "Python", 25, 0, 0, 5, 5, 35
"d:\pkr_study\08-力扣\codes\b\b03-链表两数相加.py", "Python", 45, 0, 0, 1, 12, 58
"d:\pkr_study\08-力扣\codes\b\b04-无重复字符的最长子串.py", "Python", 36, 0, 0, 19, 5, 60
"d:\pkr_study\08-力扣\codes\b\b05-元素集合的全排列.py", "Python", 25, 0, 0, 3, 7, 35
"d:\pkr_study\08-力扣\codes\b\b06-计数质数.py", "Python", 23, 0, 0, 26, 5, 54
"d:\pkr_study\08-力扣\codes\b\b07-打印二叉树.py", "Python", 33, 0, 0, 1, 8, 42
"d:\pkr_study\08-力扣\codes\b\b08-剪绳子.py", "Python", 37, 0, 0, 0, 9, 46
"d:\pkr_study\08-力扣\codes\b\b09-找出给定方程的正整数解.py", "Python", 28, 0, 0, 3, 3, 34
"d:\pkr_study\08-力扣\codes\b\b10-平衡二叉搜索树.py", "Python", 87, 0, 0, 11, 17, 115
"d:\pkr_study\08-力扣\codes\b\b100-旋转链表.py", "Python", 24, 0, 0, 28, 14, 66
"d:\pkr_study\08-力扣\codes\b\b101-分隔链表.py", "Python", 26, 0, 0, 26, 10, 62
"d:\pkr_study\08-力扣\codes\b\b102-LRU 缓存.py", "Python", 50, 0, 0, 8, 10, 68
"d:\pkr_study\08-力扣\codes\b\b103-从前序与中序遍历序列构造二叉树.py", "Python", 20, 0, 0, 1, 3, 24
"d:\pkr_study\08-力扣\codes\b\b104-从中序与后序遍历序列构造二叉树.py", "Python", 20, 0, 0, 1, 3, 24
"d:\pkr_study\08-力扣\codes\b\b105-填充每个节点的下一个右侧节点指针II.py", "Python", 28, 0, 0, 1, 5, 34
"d:\pkr_study\08-力扣\codes\b\b106-二叉树展开为链表.py", "Python", 21, 0, 0, 1, 8, 30
"d:\pkr_study\08-力扣\codes\b\b107-求根节点到叶节点数字之和.py", "Python", 23, 0, 0, 1, 5, 29
"d:\pkr_study\08-力扣\codes\b\b108-二叉搜索树迭代器.py", "Python", 27, 0, 0, 39, 12, 78
"d:\pkr_study\08-力扣\codes\b\b109-二叉树的最近公共祖先.py", "Python", 20, 0, 0, 1, 3, 24
"d:\pkr_study\08-力扣\codes\b\b11-最长数对链.py", "Python", 26, 0, 0, 9, 6, 41
"d:\pkr_study\08-力扣\codes\b\b110-长度最小的子数组.py", "Python", 24, 0, 0, 20, 6, 50
"d:\pkr_study\08-力扣\codes\b\b111-无重复字符的最长子串.py", "Python", 30, 0, 0, 2, 5, 37
"d:\pkr_study\08-力扣\codes\b\b112-有效的数独.py", "Python", 39, 0, 0, 19, 10, 68
"d:\pkr_study\08-力扣\codes\b\b12-到达首都油耗.py", "Python", 42, 0, 0, 2, 7, 51
"d:\pkr_study\08-力扣\codes\b\b13-判断二分图.py", "Python", 46, 0, 0, 0, 7, 53
"d:\pkr_study\08-力扣\codes\b\b14-最大正方形.py", "Python", 40, 0, 0, 19, 9, 68
"d:\pkr_study\08-力扣\codes\b\b15-打家劫舍.py", "Python", 22, 0, 0, 5, 4, 31
"d:\pkr_study\08-力扣\codes\b\b16-回文子串数量.py", "Python", 37, 0, 0, 31, 6, 74
"d:\pkr_study\08-力扣\codes\b\b17-二叉树展开为链表.py", "Python", 31, 0, 0, 17, 8, 56
"d:\pkr_study\08-力扣\codes\b\b18-最小路径和.py", "Python", 28, 0, 0, 0, 5, 33
"d:\pkr_study\08-力扣\codes\b\b19-零钱兑换.py", "Python", 27, 0, 0, 30, 8, 65
"d:\pkr_study\08-力扣\codes\b\b20-有效的数独.py", "Python", 55, 0, 0, 3, 5, 63
"d:\pkr_study\08-力扣\codes\b\b21-下一个排列.py", "Python", 47, 0, 0, 25, 8, 80
"d:\pkr_study\08-力扣\codes\b\b22-数组中的第K个最大元素.py", "Python", 35, 0, 0, 5, 7, 47
"d:\pkr_study\08-力扣\codes\b\b23-旋转图像.py", "Python", 33, 0, 0, 5, 5, 43
"d:\pkr_study\08-力扣\codes\b\b24-根据身高重建队列.py", "Python", 26, 0, 0, 0, 5, 31
"d:\pkr_study\08-力扣\codes\b\b25-目标和.py", "Python", 35, 0, 0, 21, 7, 63
"d:\pkr_study\08-力扣\codes\b\b26-最小栈.py", "Python", 39, 0, 0, 1, 11, 51
"d:\pkr_study\08-力扣\codes\b\b27-把二叉搜索树转换为累加树.py", "Python", 40, 0, 0, 14, 7, 61
"d:\pkr_study\08-力扣\codes\b\b28-三数之和.py", "Python", 39, 0, 0, 63, 6, 108
"d:\pkr_study\08-力扣\codes\b\b29-最长递增子序列.py", "Python", 24, 0, 0, 1, 4, 29
"d:\pkr_study\08-力扣\codes\b\b30-单词拆分.py", "Python", 25, 0, 0, 18, 7, 50
"d:\pkr_study\08-力扣\codes\b\b31-删除链表的倒数第N个结点.py", "Python", 46, 0, 0, 3, 8, 57
"d:\pkr_study\08-力扣\codes\b\b32-组合总和.py", "Python", 41, 0, 0, 3, 4, 48
"d:\pkr_study\08-力扣\codes\b\b33-不同的二叉搜索树.py", "Python", 25, 0, 0, 0, 5, 30
"d:\pkr_study\08-力扣\codes\b\b34-盛最多水的容器.py", "Python", 30, 0, 0, 0, 7, 37
"d:\pkr_study\08-力扣\codes\b\b35-电话号码的字母组合.py", "Python", 52, 0, 0, 0, 5, 57
"d:\pkr_study\08-力扣\codes\b\b36-搜索旋转排序数组.py", "Python", 45, 0, 0, 2, 5, 52
"d:\pkr_study\08-力扣\codes\b\b37-在排序数组中查找元素的第一个和最后一个位置.py", "Python", 39, 0, 0, 0, 6, 45
"d:\pkr_study\08-力扣\codes\b\b38-从前序与中序遍历序列构造二叉树.py", "Python", 30, 0, 0, 1, 4, 35
"d:\pkr_study\08-力扣\codes\b\b39-和为K的子数组.py", "Python", 32, 0, 0, 29, 5, 66
"d:\pkr_study\08-力扣\codes\b\b40-分割等和子集.py", "Python", 24, 0, 0, 11, 7, 42
"d:\pkr_study\08-力扣\codes\b\b41-路径总和 III.py", "Python", 53, 0, 0, 10, 16, 79
"d:\pkr_study\08-力扣\codes\b\b42-买卖股票的最佳时机.py", "Python", 16, 0, 0, 10, 3, 29
"d:\pkr_study\08-力扣\codes\b\b43-二叉树的最近公共祖先.py", "Python", 62, 0, 0, 20, 8, 90
"d:\pkr_study\08-力扣\codes\b\b44-每日温度.py", "Python", 19, 0, 0, 18, 6, 43
"d:\pkr_study\08-力扣\codes\b\b45-最长连续序列.py", "Python", 22, 0, 0, 4, 4, 30
"d:\pkr_study\08-力扣\codes\b\b46-单词搜索.py", "Python", 37, 0, 0, 4, 7, 48
"d:\pkr_study\08-力扣\codes\b\b47-实现前缀树.py", "Python", 49, 0, 0, 12, 11, 72
"d:\pkr_study\08-力扣\codes\b\b48-寻找重复数.py", "Python", 24, 0, 0, 6, 4, 34
"d:\pkr_study\08-力扣\codes\b\b49-课程表.py", "Python", 31, 0, 0, 53, 9, 93
"d:\pkr_study\08-力扣\codes\b\b50-除自身以外数组的乘积.py", "Python", 26, 0, 0, 14, 6, 46
"d:\pkr_study\08-力扣\codes\b\b51-完全平方数.py", "Python", 27, 0, 0, 5, 3, 35
"d:\pkr_study\08-力扣\codes\b\b52-岛屿数量.py", "Python", 32, 0, 0, 4, 5, 41
"d:\pkr_study\08-力扣\codes\b\b53-乘积最大子数组.py", "Python", 16, 0, 0, 4, 5, 25
"d:\pkr_study\08-力扣\codes\b\b54-不同路径.py", "Python", 16, 0, 0, 4, 2, 22
"d:\pkr_study\08-力扣\codes\b\b55-排序链表.py", "Python", 48, 0, 0, 20, 17, 85
"d:\pkr_study\08-力扣\codes\b\b56-打家劫舍III.py", "Python", 25, 0, 0, 26, 9, 60
"d:\pkr_study\08-力扣\codes\b\b57-LRU 缓存.py", "Python", 95, 0, 0, 9, 13, 117
"d:\pkr_study\08-力扣\codes\b\b58-环形链表.py", "Python", 24, 0, 0, 7, 6, 37
"d:\pkr_study\08-力扣\codes\b\b59-跳跃游戏.py", "Python", 18, 0, 0, 4, 4, 26
"d:\pkr_study\08-力扣\codes\b\b60-找到字符串中所有字母异位词.py", "Python", 46, 0, 0, 6, 9, 61
"d:\pkr_study\08-力扣\codes\b\b61-字母异位词分组.py", "Python", 35, 0, 0, 3, 5, 43
"d:\pkr_study\08-力扣\codes\b\b62-最长回文子串.py", "Python", 31, 0, 0, 3, 4, 38
"d:\pkr_study\08-力扣\codes\b\b63-除法求值.java", "Java", 0, 96, 0, 14, 14, 124
"d:\pkr_study\08-力扣\codes\b\b64-字符串解码.java", "Java", 0, 102, 0, 2, 13, 117
"d:\pkr_study\08-力扣\codes\b\b65-前K个高频元素.java", "Java", 0, 56, 0, 50, 19, 125
"d:\pkr_study\08-力扣\codes\b\b66-搜索二维矩阵.java", "Java", 0, 26, 0, 5, 4, 35
"d:\pkr_study\08-力扣\codes\b\b67-括号生成.java", "Java", 0, 35, 0, 2, 6, 43
"d:\pkr_study\08-力扣\codes\b\b68-全排列.java", "Java", 0, 37, 0, 0, 6, 43
"d:\pkr_study\08-力扣\codes\b\b69-任务调度器.java", "Java", 0, 20, 0, 4, 5, 29
"d:\pkr_study\08-力扣\codes\b\b70-二叉树的层序遍历.java", "Java", 0, 54, 0, 2, 12, 68
"d:\pkr_study\08-力扣\codes\b\b71-验证二叉搜索树.java", "Java", 0, 39, 0, 63, 17, 119
"d:\pkr_study\08-力扣\codes\b\b72-子集.java", "Java", 0, 25, 0, 3, 3, 31
"d:\pkr_study\08-力扣\codes\b\b73-颜色分类.java", "Java", 0, 42, 0, 4, 5, 51
"d:\pkr_study\08-力扣\codes\b\b74-最大子数组和.java", "Java", 0, 41, 0, 34, 23, 98
"d:\pkr_study\08-力扣\codes\b\b75-合并区间.java", "Java", 0, 33, 0, 16, 6, 55
"d:\pkr_study\08-力扣\codes\b\b76-最短无序连续子数组.java", "Java", 0, 27, 0, 3, 6, 36
"d:\pkr_study\08-力扣\codes\b\b77-砍竹子I.java", "Java", 0, 26, 0, 2, 5, 33
"d:\pkr_study\08-力扣\codes\b\b78-砍竹子II.java", "Java", 0, 28, 0, 3, 5, 36
"d:\pkr_study\08-力扣\codes\b\b79-只出现一次的数字II.java", "Java", 0, 16, 0, 2, 2, 20
"d:\pkr_study\08-力扣\codes\b\b80-最大单词长度乘积.java", "Java", 0, 26, 0, 3, 4, 33
"d:\pkr_study\08-力扣\codes\b\b81-删除有序数组中的重复项II.java", "Java", 0, 21, 0, 3, 2, 26
"d:\pkr_study\08-力扣\codes\b\b82-轮转数组.java", "Java", 0, 27, 0, 2, 3, 32
"d:\pkr_study\08-力扣\codes\b\b83-买卖股票的最佳时机II.java", "Java", 0, 16, 0, 13, 6, 35
"d:\pkr_study\08-力扣\codes\b\b84-跳跃游戏II.java", "Java", 0, 22, 0, 6, 3, 31
"d:\pkr_study\08-力扣\codes\b\b85-H指数.java", "Java", 0, 30, 0, 5, 2, 37
"d:\pkr_study\08-力扣\codes\b\b86-O(1)时间插入删除和获取随机元素.py", "Python", 26, 0, 0, 0, 6, 32
"d:\pkr_study\08-力扣\codes\b\b87-除自身以外数组的乘积.py", "Python", 14, 0, 0, 9, 6, 29
"d:\pkr_study\08-力扣\codes\b\b88-加油站.py", "Python", 31, 0, 0, 6, 7, 44
"d:\pkr_study\08-力扣\codes\b\b89-整数转罗马数字.py", "Python", 80, 0, 0, 0, 5, 85
"d:\pkr_study\08-力扣\codes\b\b90-反转字符串中的单词.py", "Python", 24, 0, 0, 3, 5, 32
"d:\pkr_study\08-力扣\codes\b\b91-Z字形变换.py", "Python", 24, 0, 0, 9, 7, 40
"d:\pkr_study\08-力扣\codes\b\b92-两数之和II-输入有序数组.py", "Python", 23, 0, 0, 5, 5, 33
"d:\pkr_study\08-力扣\codes\b\b93-盛最多水的容器.py", "Python", 27, 0, 0, 6, 7, 40
"d:\pkr_study\08-力扣\codes\b\b94-三数之和.py", "Python", 34, 0, 0, 3, 5, 42
"d:\pkr_study\08-力扣\codes\b\b95-两数相加.py", "Python", 41, 0, 0, 1, 4, 46
"d:\pkr_study\08-力扣\codes\b\b96-随机链表的复制.py", "Python", 33, 0, 0, 29, 10, 72
"d:\pkr_study\08-力扣\codes\b\b97-反转链表II.py", "Python", 24, 0, 0, 16, 8, 48
"d:\pkr_study\08-力扣\codes\b\b98-删除链表的倒数第N个结点.py", "Python", 22, 0, 0, 22, 10, 54
"d:\pkr_study\08-力扣\codes\b\b99-删除排序链表中的重复元素II.py", "Python", 25, 0, 0, 3, 8, 36
"d:\pkr_study\08-力扣\codes\c\c01-合法括号字符串路径.py", "Python", 84, 0, 0, 0, 8, 92
"d:\pkr_study\08-力扣\codes\c\c02-滑动窗口最大值.py", "Python", 36, 0, 0, 34, 11, 81
"d:\pkr_study\08-力扣\codes\c\c03-编辑距离.py", "Python", 34, 0, 0, 0, 5, 39
"d:\pkr_study\08-力扣\codes\c\c04-戳气球.py", "Python", 28, 0, 0, 3, 5, 36
"d:\pkr_study\08-力扣\codes\c\c05-寻找两个正序数组的中位数.py", "Python", 20, 0, 0, 39, 6, 65
"d:\pkr_study\08-力扣\codes\c\c06-柱状图中最大的矩形.py", "Python", 27, 0, 0, 43, 10, 80
"d:\pkr_study\08-力扣\codes\c\c07-删除无效的括号.py", "Python", 53, 0, 0, 22, 9, 84
"d:\pkr_study\08-力扣\codes\c\c08-二叉树中的最大路径和.py", "Python", 30, 0, 0, 43, 12, 85
"d:\pkr_study\08-力扣\codes\c\c09-正则表达式匹配.py", "Python", 28, 0, 0, 61, 14, 103
"d:\pkr_study\08-力扣\codes\c\c10-二叉树的序列化与反序列化.java", "Java", 0, 65, 0, 15, 14, 94
"d:\pkr_study\08-力扣\codes\c\c11-接雨水.java", "Java", 0, 29, 0, 23, 5, 57
"d:\pkr_study\08-力扣\codes\c\c12-最长有效括号.java", "Java", 0, 48, 0, 27, 6, 81
"d:\pkr_study\08-力扣\codes\c\c13-合并K个升序链表.java", "Java", 0, 106, 0, 14, 21, 141
"d:\pkr_study\08-力扣\codes\c\c14-最大矩形.java", "Java", 0, 51, 0, 21, 6, 78
"d:\pkr_study\08-力扣\codes\c\c15-最小覆盖子串.java", "Java", 0, 43, 0, 2, 7, 52
"d:\pkr_study\08-力扣\codes\c\c16-树中距离之和.py", "Python", 61, 0, 0, 1, 13, 75
"d:\pkr_study\08-力扣\codes\c\c17-最大矩形.py", "Python", 37, 0, 0, 1, 4, 42
"d:\pkr_study\08-力扣\codes\c\c18-分发糖果.py", "Python", 25, 0, 0, 6, 10, 41
"d:\pkr_study\08-力扣\codes\c\c19-接雨水.py", "Python", 22, 0, 0, 2, 7, 31
"d:\pkr_study\08-力扣\codes\c\c20-文本左右对齐.py", "Python", 48, 0, 0, 9, 10, 67
"d:\pkr_study\08-力扣\codes\c\c21-K个一组翻转链表.py", "Python", 28, 0, 0, 1, 8, 37
"d:\pkr_study\08-力扣\codes\c\c22-二叉树中的最大路径和.py", "Python", 25, 0, 0, 14, 8, 47
"d:\pkr_study\08-力扣\codes\c\c23-串联所有单词的子串.py", "Python", 38, 0, 0, 6, 10, 54
"d:\pkr_study\08-力扣\codes\c\c24-最小覆盖子串.py", "Python", 35, 0, 0, 3, 11, 49
"d:\pkr_study\08-力扣\codes\test.py", "Python", 12, 0, 0, 0, 1, 13
"Total", "-", 4656, 1397, 50, 1814, 1268, 9185